//MAP CONVERTED BY dmm2tgm.py THIS HEADER COMMENT PREVENTS RECONVERSION, DO NOT REMOVE
"aO" = (
/obj/structure/sign/nanotrasen,
/turf/closed/wall/mineral/titanium/nodiagonal,
/area/ship/medical)
"bA" = (
/turf/closed/wall/mineral/titanium,
/area/ship/bridge)
"bN" = (
/obj/machinery/atmospherics/pipe/simple/supply/hidden/layer2,
/obj/structure/cable{
	icon_state = "1-8"
	},
/obj/effect/turf_decal/industrial/stand_clear/red,
/obj/effect/decal/cleanable/blood/drip,
/turf/open/floor/plasteel/white,
/area/ship/medical)
"cf" = (
/obj/machinery/atmospherics/components/unary/vent_pump/on/layer2{
	dir = 4
	},
/obj/structure/cable{
	icon_state = "1-2"
	},
/obj/structure/cable{
	icon_state = "1-4"
	},
/obj/effect/decal/cleanable/oil/slippery,
/obj/machinery/atmospherics/pipe/simple/purple/visible,
/obj/structure/sign/poster/random{
	pixel_x = -29
	},
/turf/open/floor/plasteel/tech,
/area/ship/engineering)
"cr" = (
/obj/machinery/power/apc/auto_name/directional/east,
/obj/machinery/atmospherics/components/unary/vent_scrubber/on/layer4{
	dir = 1
	},
/obj/machinery/atmospherics/pipe/simple/supply/hidden/layer2{
	dir = 9
	},
/obj/structure/cable{
	icon_state = "0-8"
	},
/obj/effect/turf_decal/techfloor{
	dir = 5
	},
/obj/effect/decal/cleanable/robot_debris,
/turf/open/floor/plasteel/tech/grid,
/area/ship/engineering)
"dc" = (
/obj/effect/turf_decal/corner/opaque/blue/half{
	dir = 1
	},
/turf/open/floor/plasteel/white,
/area/ship/medical)
"dB" = (
/obj/machinery/atmospherics/components/unary/vent_pump/on/layer2,
/obj/structure/table,
/obj/item/reagent_containers/food/drinks/trophy/bronze_cup{
	pixel_y = 10;
	name = "bronze cup - NT's third most terrible shuttle";
	desc = "At least you're not first!"
	},
/turf/open/floor/mineral/titanium/white,
/area/ship/bridge)
"dG" = (
/obj/structure/chair/comfy/shuttle{
	dir = 1
	},
/obj/machinery/atmospherics/pipe/simple/scrubbers/hidden/layer2{
	dir = 4
	},
/turf/open/floor/plasteel/white,
/area/ship/medical)
"er" = (
/obj/machinery/atmospherics/pipe/simple/supply/hidden/layer2{
	dir = 5
	},
/obj/machinery/advanced_airlock_controller{
	pixel_x = -25;
	req_access = list(150)
	},
/obj/structure/catwalk/over/plated_catwalk/dark,
/turf/open/floor/plating,
/area/ship/medical)
"eA" = (
/obj/effect/turf_decal/industrial/warning{
	dir = 1
	},
/obj/machinery/atmospherics/pipe/manifold/supply/hidden/layer2{
	dir = 8
	},
/turf/open/floor/plasteel/white,
/area/ship/medical)
"eX" = (
/turf/closed/wall/mineral/titanium/nodiagonal,
/area/ship/bridge)
"fG" = (
/turf/closed/wall/mineral/titanium/nodiagonal,
/area/ship/medical)
"fS" = (
/obj/machinery/power/apc/auto_name/directional/east,
/obj/structure/cable,
/turf/open/floor/plasteel/white,
/area/ship/medical)
"ga" = (
/obj/effect/turf_decal/number/seven{
	color = "#000000"
	},
/turf/closed/wall/mineral/titanium/nodiagonal,
/area/ship/engineering)
"hk" = (
/obj/machinery/atmospherics/components/unary/outlet_injector/on/layer2{
	dir = 1
	},
/turf/open/floor/engine/hull,
/area/ship/external)
"hv" = (
/obj/machinery/atmospherics/components/unary/tank/fuel,
/obj/structure/cable{
	icon_state = "2-4"
	},
/obj/item/radio/intercom/directional/north,
/obj/effect/decal/cleanable/cobweb,
/turf/open/floor/plasteel/tech/grid,
/area/ship/engineering)
"im" = (
/obj/machinery/light/directional/east,
/obj/machinery/power/terminal{
	dir = 1
	},
/obj/effect/turf_decal/techfloor{
	dir = 6
	},
/obj/effect/decal/cleanable/shreds,
/obj/machinery/atmospherics/components/unary/portables_connector{
	dir = 8
	},
/obj/structure/cable/yellow{
	icon_state = "0-6"
	},
/turf/open/floor/plasteel/tech/grid,
/area/ship/engineering)
"ip" = (
/obj/machinery/power/apc/auto_name/directional/west,
/obj/machinery/atmospherics/components/unary/vent_scrubber/on/layer4{
	dir = 1
	},
/obj/structure/cable,
/obj/effect/turf_decal/borderfloorwhite,
/turf/open/floor/plasteel/white,
/area/ship/bridge)
"iM" = (
/obj/machinery/atmospherics/pipe/simple/scrubbers/hidden/layer4{
	dir = 8
	},
/obj/machinery/atmospherics/pipe/simple/supply/hidden/layer2{
	dir = 4
	},
/obj/machinery/door/airlock/engineering/glass{
	dir = 4;
	name = "Engineering"
	},
/obj/structure/cable{
	icon_state = "4-8"
	},
/obj/machinery/door/firedoor/border_only{
	dir = 4
	},
/obj/machinery/door/firedoor/border_only{
	dir = 8
	},
/obj/structure/cable/yellow{
	icon_state = "5-9"
	},
/turf/open/floor/plasteel/tech,
/area/ship/engineering)
"iQ" = (
/obj/machinery/power/smes,
/obj/machinery/airalarm{
	dir = 4;
	pixel_x = 33
	},
/obj/structure/cable{
	icon_state = "0-8"
	},
/turf/open/floor/plasteel/tech/grid,
/area/ship/engineering)
"kN" = (
/obj/machinery/atmospherics/pipe/simple/scrubbers/hidden/layer4{
	dir = 8
	},
/obj/machinery/atmospherics/pipe/simple/supply/hidden/layer2{
	dir = 4
	},
/obj/structure/cable{
	icon_state = "4-8"
	},
/obj/effect/turf_decal/corner/opaque/blue/half{
	dir = 8
	},
/obj/structure/cable{
	icon_state = "2-8"
	},
/turf/open/floor/plasteel/white,
/area/ship/medical)
"kR" = (
/obj/machinery/atmospherics/pipe/manifold/scrubbers/hidden/layer4,
/obj/machinery/atmospherics/pipe/simple/supply/hidden/layer2{
	dir = 4
	},
/obj/structure/cable{
	icon_state = "4-8"
	},
/obj/structure/cable{
	icon_state = "2-8"
	},
/obj/structure/cable{
	icon_state = "1-8"
	},
/obj/structure/closet/emcloset/wall{
	dir = 1;
	pixel_y = -28
	},
/obj/item/clothing/suit/space/orange,
/obj/item/clothing/suit/space/orange,
/obj/item/clothing/suit/space/orange,
/obj/item/clothing/suit/space/orange,
/obj/item/tank/internals/oxygen,
/obj/item/tank/internals/oxygen,
/obj/item/tank/internals/oxygen,
/obj/item/tank/internals/oxygen,
/obj/item/clothing/head/helmet/space/orange,
/obj/item/clothing/head/helmet/space/orange,
/obj/item/clothing/head/helmet/space/orange,
/obj/item/clothing/head/helmet/space/orange,
/turf/open/floor/plasteel/white,
/area/ship/medical)
"mg" = (
/obj/machinery/atmospherics/pipe/simple/scrubbers/hidden/layer2{
	dir = 4
	},
/turf/closed/wall/mineral/titanium/nodiagonal,
/area/ship/medical)
"mn" = (
/obj/machinery/door/airlock/external,
/obj/machinery/atmospherics/pipe/simple/supply/hidden/layer2,
/turf/open/floor/plasteel/tech,
/area/ship/medical)
"mU" = (
/obj/machinery/computer/helm{
	dir = 8
	},
/obj/machinery/light/small/directional/east,
/turf/open/floor/plasteel/mono/white,
/area/ship/bridge)
"nA" = (
/obj/structure/window/reinforced/spawner/west,
/obj/effect/turf_decal/techfloor,
/obj/machinery/door/firedoor/border_only{
	dir = 8
	},
/obj/machinery/atmospherics/components/unary/shuttle/heater{
	dir = 4
	},
/turf/open/floor/plasteel/tech/grid,
/area/ship/engineering)
"oe" = (
/obj/effect/turf_decal/number/seven,
/turf/closed/wall/mineral/titanium/nodiagonal,
/area/ship/engineering)
"ov" = (
/obj/machinery/atmospherics/pipe/simple/scrubbers/hidden/layer4{
	dir = 8
	},
/obj/machinery/atmospherics/pipe/simple/supply/hidden/layer2{
	dir = 4
	},
/obj/structure/cable{
	icon_state = "4-8"
	},
/obj/effect/decal/cleanable/blood/drip{
	pixel_x = 14
	},
/obj/machinery/holopad/emergency/medical,
/obj/effect/turf_decal/corner/opaque/blue/full,
/turf/open/floor/plasteel/white,
/area/ship/medical)
"pS" = (
/obj/machinery/atmospherics/components/unary/vent_scrubber/on/layer4,
/obj/structure/cable{
	icon_state = "1-2"
	},
/obj/effect/turf_decal/industrial/warning{
	dir = 1
	},
/turf/open/floor/plasteel/white,
/area/ship/medical)
"pZ" = (
/obj/machinery/atmospherics/pipe/simple/supply/hidden/layer2{
	dir = 6
	},
/obj/structure/cable{
	icon_state = "1-4"
	},
/obj/effect/turf_decal/techfloor{
	dir = 1
	},
/obj/effect/decal/cleanable/insectguts,
/obj/machinery/atmospherics/pipe/simple/purple/visible{
	dir = 9
	},
/turf/open/floor/plasteel/tech/grid,
/area/ship/engineering)
"sx" = (
/obj/machinery/atmospherics/pipe/simple/scrubbers/hidden/layer4{
	dir = 8
	},
/obj/structure/cable{
	icon_state = "4-8"
	},
/obj/effect/turf_decal/corner/opaque/blue/half{
	dir = 4
	},
/obj/machinery/atmospherics/pipe/manifold/supply/hidden/layer2,
/obj/structure/closet/firecloset/wall{
	dir = 1;
	pixel_y = -28
	},
/turf/open/floor/plasteel/white,
/area/ship/medical)
"tR" = (
/obj/structure/window/reinforced/spawner/west,
/obj/effect/turf_decal/techfloor{
	dir = 1
	},
/obj/machinery/door/firedoor/border_only{
	dir = 8
	},
/obj/machinery/atmospherics/components/unary/shuttle/heater{
	dir = 4
	},
/turf/open/floor/plasteel/tech/grid,
/area/ship/engineering)
"tY" = (
/turf/open/floor/plasteel/tech/grid,
/area/ship/engineering)
"vd" = (
/obj/effect/turf_decal/borderfloorwhite/corner{
	dir = 8
	},
/obj/machinery/suit_storage_unit/inherit,
/obj/item/tank/internals/oxygen,
/obj/item/clothing/suit/space/orange,
/obj/item/clothing/head/helmet/space/orange,
/turf/open/floor/plasteel/mono/white,
/area/ship/bridge)
"vf" = (
/turf/template_noop,
/area)
"vK" = (
/obj/machinery/atmospherics/pipe/simple/scrubbers/hidden/layer4{
	dir = 8
	},
/obj/machinery/atmospherics/pipe/simple/supply/hidden/layer2{
	dir = 4
	},
/obj/machinery/door/airlock/command{
	name = "Helm";
	dir = 4
	},
/obj/structure/cable{
	icon_state = "4-8"
	},
/obj/machinery/door/firedoor/border_only{
	dir = 4
	},
/obj/machinery/door/firedoor/border_only{
	dir = 8
	},
/turf/open/floor/plasteel/white,
/area/ship/bridge)
"wd" = (
/obj/structure/cable{
	icon_state = "1-2"
	},
/obj/effect/turf_decal/techfloor,
/obj/machinery/atmospherics/pipe/manifold4w/purple/visible,
/turf/open/floor/plasteel/tech/grid,
/area/ship/engineering)
"wh" = (
/obj/machinery/atmospherics/pipe/simple/scrubbers/hidden/layer2{
	dir = 10
	},
/turf/closed/wall/mineral/titanium,
/area/ship/bridge)
"wS" = (
/obj/machinery/door/poddoor{
	name = "Ambulance door";
	id = "ambulancenorth"
	},
/obj/machinery/power/shieldwallgen/atmos/roundstart{
	dir = 8;
	id = "ambnorthholo"
	},
/obj/structure/cable{
	icon_state = "0-2"
	},
/obj/machinery/door/firedoor/border_only,
/obj/machinery/atmospherics/pipe/layer_manifold,
/turf/open/floor/plasteel/tech/grid,
/area/ship/medical)
"yS" = (
/obj/machinery/door/poddoor{
	name = "Ambulance door";
	id = "ambulancenorth"
	},
/obj/machinery/power/shieldwallgen/atmos/roundstart{
	dir = 4;
	id = "ambnorthholo"
	},
/obj/structure/cable{
	icon_state = "0-2"
	},
/obj/machinery/door/firedoor/border_only,
/obj/docking_port/mobile{
	dir = 2;
	preferred_direction = 2;
	port_direction = 8;
	name = "Ambulance"
	},
/obj/structure/cable/yellow{
	icon_state = "1-10"
	},
/obj/machinery/atmospherics/pipe/layer_manifold,
/turf/open/floor/plasteel/tech/grid,
/area/ship/medical)
"yU" = (
/obj/machinery/atmospherics/pipe/simple/scrubbers/hidden/layer4{
	dir = 9
	},
/obj/structure/cable{
	icon_state = "1-2"
	},
/obj/structure/cable{
	icon_state = "2-4"
	},
/obj/effect/turf_decal/industrial/stand_clear/red,
/turf/open/floor/plasteel/white,
/area/ship/medical)
"AY" = (
/obj/effect/turf_decal/number/two{
	color = "#000000"
	},
/turf/closed/wall/mineral/titanium/nodiagonal,
/area/ship/engineering)
"Be" = (
/obj/effect/turf_decal/number/three{
	color = "#000000"
	},
/turf/closed/wall/mineral/titanium,
/area/ship/engineering)
"Bu" = (
/turf/closed/wall/mineral/titanium,
/area/ship/engineering)
"Bx" = (
/obj/structure/table/optable,
/obj/effect/decal/cleanable/blood/old,
/turf/open/floor/mineral/titanium/blue,
/area/ship/medical)
"BF" = (
/obj/effect/turf_decal/number/two,
/turf/closed/wall/mineral/titanium/nodiagonal,
/area/ship/engineering)
"BZ" = (
/obj/machinery/airalarm{
	dir = 1;
	pixel_y = 31
	},
/obj/machinery/atmospherics/pipe/simple/scrubbers/hidden/layer4{
	dir = 6
	},
/obj/machinery/button/door{
	dir = 4;
	pixel_x = -25;
	pixel_y = -1;
	id = "ambulancenorth";
	name = "Ambulance door button"
	},
/obj/machinery/button/shieldwallgen{
	dir = 4;
	pixel_y = 7;
	pixel_x = -23;
	id = "ambnorthholo"
	},
/obj/machinery/stasis{
	dir = 4
	},
/obj/effect/turf_decal/industrial/warning{
	dir = 4
	},
/obj/structure/cable/yellow{
	icon_state = "2-5"
	},
/turf/open/floor/mineral/titanium/blue,
/area/ship/medical)
"Cf" = (
/obj/structure/sign/departments/medbay/alt,
/turf/closed/wall/mineral/titanium/nodiagonal,
/area/ship/medical)
"DQ" = (
/obj/machinery/atmospherics/pipe/simple/scrubbers/hidden/layer4,
/obj/effect/turf_decal/industrial/warning/corner{
	dir = 4
	},
/obj/structure/chair/comfy/shuttle{
	dir = 4
	},
/obj/structure/cable/yellow{
	icon_state = "1-10"
	},
/turf/open/floor/plasteel/white,
/area/ship/medical)
"Ef" = (
/obj/structure/chair/comfy/shuttle{
	dir = 1
	},
/obj/machinery/atmospherics/pipe/simple/scrubbers/hidden/layer2{
	dir = 4
	},
/obj/machinery/light/directional/south,
/turf/open/floor/plasteel/white,
/area/ship/medical)
"Ev" = (
/obj/machinery/door/airlock/external,
/turf/open/floor/plasteel/tech,
/area/ship/medical)
"Ft" = (
/obj/machinery/telecomms/relay{
	network = "NTPANACEA";
	id = "AMBULANCE"
	},
/obj/machinery/atmospherics/pipe/simple/scrubbers/hidden/layer2{
	dir = 4
	},
/turf/open/floor/plasteel/telecomms_floor,
/area/ship/bridge)
"FF" = (
/obj/machinery/atmospherics/pipe/simple/scrubbers/hidden/layer4{
	dir = 6
	},
/obj/machinery/atmospherics/pipe/manifold/supply/hidden/layer2{
	dir = 1
	},
/obj/structure/cable{
	icon_state = "4-8"
	},
/turf/open/floor/plasteel/tech,
/area/ship/engineering)
"HV" = (
/turf/closed/wall/mineral/titanium/nodiagonal,
/area/ship/engineering)
"IK" = (
/obj/machinery/atmospherics/pipe/simple/scrubbers/hidden/layer4{
	dir = 10
	},
/obj/machinery/atmospherics/pipe/simple/supply/hidden/layer2{
	dir = 9
	},
/obj/structure/cable{
	icon_state = "2-8"
	},
/turf/open/floor/plasteel/white,
/area/ship/bridge)
"Lc" = (
/obj/structure/sign/poster/official/cleanliness,
/turf/closed/wall/mineral/titanium/nodiagonal,
/area/ship/medical)
"Mo" = (
/turf/open/floor/engine/hull,
/area/ship/external)
"Ok" = (
/obj/structure/sign/poster/official/help_others,
/obj/machinery/atmospherics/pipe/simple/scrubbers/hidden/layer2{
	dir = 4
	},
/turf/closed/wall/mineral/titanium/nodiagonal,
/area/ship/medical)
"OR" = (
/obj/machinery/atmospherics/pipe/manifold/scrubbers/hidden/layer4,
/obj/structure/cable{
	icon_state = "4-8"
	},
/obj/machinery/atmospherics/pipe/manifold/supply/hidden/layer2{
	dir = 1
	},
/turf/open/floor/plasteel/white,
/area/ship/medical)
"PG" = (
/obj/effect/spawner/structure/window/shuttle,
/turf/open/floor/plating,
/area/ship/bridge)
"Qq" = (
/obj/effect/turf_decal/number/three,
/turf/closed/wall/mineral/titanium,
/area/ship/engineering)
"RN" = (
/obj/machinery/atmospherics/components/unary/vent_pump/on/layer2{
	dir = 8
	},
/obj/structure/chair/comfy/shuttle{
	dir = 1
	},
/turf/open/floor/plasteel/white,
/area/ship/medical)
"ST" = (
/obj/machinery/power/shuttle/engine/fueled/plasma{
	dir = 4
	},
/turf/open/floor/plating,
/area/ship/engineering)
"Ts" = (
/obj/machinery/atmospherics/components/binary/dp_vent_pump/layer2{
	dir = 4
	},
/obj/machinery/light/small/directional/east,
/turf/open/floor/plasteel/tech,
/area/ship/medical)
"UJ" = (
/obj/machinery/atmospherics/components/unary/tank/air{
	dir = 1;
	piping_layer = 2
	},
/turf/open/floor/plasteel/tech/grid,
/area/ship/engineering)
"UQ" = (
/obj/machinery/airalarm{
	dir = 8;
	pixel_x = -33
	},
/obj/machinery/atmospherics/pipe/simple/supply/hidden/layer2,
/obj/structure/chair/comfy/shuttle{
	dir = 4;
	name = "Pilot's seat"
	},
/turf/open/floor/plasteel/white,
/area/ship/bridge)
"VK" = (
/obj/machinery/computer/operating,
/obj/effect/turf_decal/industrial/warning{
	dir = 8
	},
/turf/open/floor/mineral/titanium/blue,
/area/ship/medical)
"XA" = (
/obj/effect/turf_decal/industrial/warning/corner{
	dir = 1
	},
/obj/effect/turf_decal/corner/opaque/blue/half,
/obj/machinery/atmospherics/pipe/simple/supply/hidden/layer2{
	dir = 4
	},
/obj/structure/rack,
/obj/item/storage/firstaid/medical,
/obj/item/roller,
/obj/item/roller,
/turf/open/floor/plasteel/white,
/area/ship/medical)
"XB" = (
/obj/effect/spawner/structure/window/shuttle,
/turf/open/floor/plating,
/area/ship/medical)
"XC" = (
/obj/machinery/computer/crew{
	dir = 8
	},
/obj/item/radio/intercom/wideband{
	dir = 1;
	pixel_y = 32
	},
/turf/open/floor/plasteel/mono/white,
/area/ship/bridge)
"Yh" = (
/obj/item/radio/intercom,
/obj/machinery/atmospherics/pipe/simple/scrubbers/hidden/layer2{
	dir = 4
	},
/turf/closed/wall/mineral/titanium/nodiagonal,
/area/ship/bridge)

(1,1,1) = {"
vf
Bu
ST
HV
ST
Bu
vf
"}
(2,1,1) = {"
Be
HV
nA
HV
tR
HV
Qq
"}
(3,1,1) = {"
AY
hv
wd
cf
pZ
UJ
BF
"}
(4,1,1) = {"
ga
iQ
im
FF
cr
tY
oe
"}
(5,1,1) = {"
fG
fG
fG
iM
fG
fG
fG
"}
(6,1,1) = {"
fG
BZ
DQ
OR
mn
er
fG
"}
(7,1,1) = {"
yS
yU
pS
kR
fG
Ts
Ev
"}
(8,1,1) = {"
wS
bN
eA
sx
fG
mg
fG
"}
(9,1,1) = {"
Cf
VK
XA
ov
dc
Ef
Cf
"}
(10,1,1) = {"
XB
Bx
RN
kN
fS
dG
fG
"}
(11,1,1) = {"
aO
Lc
fG
vK
fG
Ok
aO
"}
(12,1,1) = {"
eX
dB
UQ
IK
ip
Ft
eX
"}
(13,1,1) = {"
bA
eX
XC
mU
vd
Yh
bA
"}
(14,1,1) = {"
Mo
bA
PG
bA
PG
wh
hk
"}
